000000000000000000000000000000
011110011110011110011110011110
011110011110011110011110011110
011110011110011110011110011110
000000000000000000000000000000
011110011110000000011110011110
011110011110000000011110011110
011110011110000000011110011110
000000000000000000000000000000
011110000000000000000000011110
011110000000000000000000011110
011110000000000000000000011110
000000000000000000000000000000
011110011110000000011110011110
011110011110000000011110011110
011110011110000000011110011110
000000000000000000000000000000
011110011110011110011110011110
011110011110011110011110011110
000000000000000000000000000000