000000000000000000000000000000
001111111000000000000000000000
000001100000000000000000000000
000001100000000111000000000000
001101100000001101100000000000
000111000000011000110000000000
000000000000011111110000000000
000000000000011000110000000000
000000000000000000000000000000
000000000000000000000000000000
000000000000000000000000000000
000110000011000000000000000000
000110000011000000000000000000
000011000110000000000000000000
000001101100000000000001110000
000000111000000000000011011000
000000000000000000000110001100
000000000000000000000111111100
000000000000000000000110001100
000000000000000000000000000000
