011111000000000000000000000000
000011111000000000000000000000
000000111110000000000000001111
000011111000000000000000000111
000000000000000111111111000011
000000000000111111000011110011
000000000011111111110000111011
000000000000011111111100001111
000000000000000000000000011000
000000000000000000000000000000
000000000000000000000000000000
000000000000000000000000000011
000000000000000000000000011111
000000000000000000000000000111
000000000000000000000000000001
000000000000000000000000000000
000000011111111111111110000000
001111111111111111100000000000
000000001111111111110000000000
000001111111100011111111100000
